  ####
  #  #
###  #
#@*$ #
#   ##
#####

######
#.@$ #
#$*  #
#    #
##  ##
 ####

       ####
########  ##
#          ###
# @$$ ##   ..#
# $$   ##  ..#
#         ####
###########

      #####
  #####   #####
  #           #
  #  ### ###  #
#### #     # ####
#    #  *  #    #
# $  # *@*      #
#    #  *  #    #
#### #     # ####
  #  ### ###  #
  #           #
  #####   #####
      #####

#########
#       ##
#        #
# @* #   #
#  **   ##
#   **$ #
#     # #
#    #  #
####   ##
   #####

 ###### #####
##.   ###   #
#@*     *   #
##  ####** ##
 ####  $ *  #
    # ##    #
    #  ##   #
    # # $ ###
    #   # #
    ##    #
     ###  #
       ####

  ######
 ##    #####
 #     #   #
 # ****    #
 #    ##  ##
 #     # ##
 # ##### #
 #     # ##
##     #  #
#  ***@#$ #
#      #  #
###########

####
#  ####
#     #
# @** #
#     #
### ###
 #    #
##    #
# ***##
#    #
### ####
#      #
#    # #
# ***$ #
#    ###
######

    #####
  ###   ####
  #   $    #
  # ## ### #
  # # .  # #
### #    # #
#   *   *# #
#   ** **  #
####*   *# #
  #      # #
  #   @  # #
  #  #$### #
  #  #     #
  ##########

######
#    #
# ## ###
#  #   ##
#  $* . ##
#  .*$@. #
#    $$  #
#  .*$.. #
#  $* * ##
#  #   ##
# ## ###
#    #
######

   ########
####      ##
#  #       #
#  $$$     #
#   $.**   #
###...@...###
 #   **.$   #
 #     $$$  #
 #       #  #
 ##      ####
  ########

#########
#       #
# $. .$ #
# **$*. #
#  $@$  #
#  *$*. #
# *. .$ #
#       #
#########

  ########
 ##      #
 #       ###
##         #
#   #$$    #
# $$  $$   #
## $$  $$ ##
 #  $$  $$#
 ## .#.#. ##
 # . . . . #
 #  . @ .  #
 ##. . . .##
  #########

######## ####  ####
#   #  ###  ####  #####
# #   *   *@  # *  #  #
#    ** #  *    **    #
#####  ##   #  # $   ##
    #   #######  ##  #
 ####  ##  # #    # ##
 #   **      #  # ###
 #   *    ***     #
 ##   ##     ######
  ###  #   ###
    #  ## ##
    #     #
    #######

#####
#   ##
# *. #
# ** #
#  $ ####
#   #   ##
# *.  *. #
# **  ** #
#  $   $ #
##   #  ##
 #### *@ #
    # ** #
    #  $ #
    ##   #
     #####

####   ####
#  #####  #
#         #
#  ## ### ####
## #.$  # #  #
 # #.*$  $*. #
 # # .$ $*.  #
 #  $  @     #
 # # .$ $*.  #
 # #.*$  $*. #
## #.$  # #  #
#  ## ### ####
#         #
#  #####  #
####   ####

 ###  ####
 # ####  #
 # $     #
 # ###   #
##   ### ####
#      @    #
#   ## # ## #
#.####      #
###  ########

 #########
 #  #    #
 #       #
 # ##   ####
 #.# $@$ #.#
## #    ## #
#  ######  ##
#           #
## ######  ##
 ###    ####

 #########
 #  #    #
 #       #
 # ## $ ####
 #.# $@$ #.#
## #    ## #
#  ######  ##
#         . #
## ######  ##
 ###    ####

    #########
   ##       ##
  ##  #####  #
  #  ##   ## #
### ##  $  # #
#      *@*.# #
#       #  # #
######### ## #
     #   $   #
     #### # ##
        #   #
        #####

      ###########
   ####         ####
   #    ### ###    #
#### ####     #### ####
#    #    # #    #    #
# #### ####$#### #### #
# #    #   .   #    # #
# # ######@  ###### # #
# #      .$ $.    @ # #
# ########   ######## #
#    #   ## ##   #    #
#### #    * *    # ####
   # ##### # ##### #
   #               #
   #################

                  ################
 ##################              #
 #                # ### ###   ## #
 # #  ## ######                # ###
 # ##  #      # # ### ######   #   #
 #  ## ###### # # #                #
 #                ########## ### # #
 #  ## # #######           #   # # #
 #     #          ######## #   # # #
 #  ############  #                #
 #  #         # $@#. #######  #### #
 # ## #### #####  #        ####  ###
## #     # #   #### # #          #
#  #### ## #        # # #######  #
#            ######## # #  #  #  #
## ####### # #    #              #
 # #  #  # # #### #############  ##
 #                                #
 ##############################   #
                              #####

 ########
##   #  #
#       #
#    #  ####
###  # ##  ####
 #   # #      #
 #   # #      #
 # ### # ## ###
 #  # $@* # #
 #  ##   ## #
##   ##     ###
#             #
#   #######   #
#####     #####

          #####
   ########   #
   #  #  #  # #
   #     $  # #
####  ###*### ####
#       *@*      #
#   # # #*# #### #
### # # #     #  #
  # # # # ### #  #
  # #   #   #   ##
  # ##### #######
  #       #
  #########

      ########
  #####      #
  #     #### #
### ###$#  # #
#   #      # ###
# ### #### #   #
#     *@*  ### #
###  #.**    # #
  #### $ ### # #
     ##  #   # #
     #  ## ### #
     #  ## #   #
     #  #    ###
     #    ####
     ######

      #####
  #####   ##
  #     #  #
### #####  #
#   #   #  #
# ######## ######
# #      $*#    #
# # # ###*@*  # #
# #      ***  # #
# ########  ### #
#      #    #   #
###### # # ## ###
     #        #
     ##########

 ####    #########
 #  ######       #
 #         ##### #
 # ##### ###   # #
## #   **.     # #
#  #   * *###### #
#      **@   #   #
#######  #$#$# ###
      #        #
      ##  ######
       ####

      #   #
####### # #####
#       #     #
# ##### ##### #
# #    $    # #
# #   *.*   # #
# #   *@*   # #
# #   **.#  # #
# #    #    # #
# #### ### ## #
#     $ $     #
#####   ## ####
    ## ##  #
    #     ##
    #######

######
#    ###########
#              #
#  ##########  #
#  #   #    # ##
#      #    # #
#  ###      # #
## # @*     # #
 # #  **    # #
 # #   **  ## #
## #    ** #  ##
#  #     **    #
#  ###### $#   #
#          #####
#  #########
####
